11111111111111111111111
10C00001000C100000000C1
11100101001110111111101
100001C10010001001C0101
10011111001001100100101
1C000001C00011000100101
111111C1111110000100101
1000C10000000000110C101
10011100111001111001101
100100001C1111000000001
10010110100000011111101
1E00001000P0000C0C001C1
11111111111111111111111