111111111111111111111111
1000D00000000D000D00D001
100000000000000000000001
100111001110011100111001
100101000010000100101001
100D01001110011100001001
100001000010000100001001
100011101110011100001001
1000D0D000D000D00000D001
10E0000000C0000000000P01
111111111111111111111111